cringe	съеживаться
blush	краснеть
stammer	заикаться
stings	жалит
huge blow	огромный удар
textbook example	пример из учебника
deep down	в глубине души
pursue	преследовать
a leap of faith	a risk
crushed	раздавленный
prompted	подсказал
deliberate	преднамеренный
diligently	старательно
ponder	обдумывать
brace himself	приготовься
painstakingly	кропотливо
glitters	блестит
superseded	заменен
revel in	упиваться
went viral	стал вирусным
quest	поиск
jump-starting	рывок
dwelling on	остановившись на